AB|ORGANIZACIÓN DE COMUNICACIONES POR SATÉLITE ÁRABE
ABS|TRANSMISIÓN DE SATÉLITE DE ASIA
AGO|REPÚBLICA DE ANGOLA
ANG|?
AC|ASIA COMPAÑÍA DE TELECOMUNICACIONES POR SATÉLITE (ASIASAT)
ALG|ARGELIA
ANG|?
ARGN|?
ASRA|?
AUS|?
AZER|AZERBAIYÁN
BEL|BÉLGICA
BELA|?
BERM|?
BGD|?
BGR|?
BHUT|BUTÁN
BOL|?
BUL|?
BRAZ|BRASIL
BT|BUTÁN
CA|CANADÁ
CHBZ|CHINA/BRASIL
CHLE|?
CIS|COMUNIDAD DE ESTADOS INDEPENDIENTES (EX USSR)
COL|?
CRI|?
CZ|?
CZE|?
CZCH|REPÚBLICA CHECA (EX CHECOSLOVAQUIA)
DEN|DINAMARCA
ECU|?
EGYP|EGYPEGIPTO
ESA|AGENCIA ESPACIAL EUROPEA
ESRO|ORGANIZACIÓN EUROPEA DE INVESTIGACIÓN ESPACIAL
EST|?
EUME|ORGANIZACIÓN EUROPEA PARA LA EXPLOTACIÓN DE SATÉLITES METEOROLÓGICOS (EUMETSAT)
EUTE|ORGANIZACIÓN EUROPEA DE SATÉLITES DE TELECOMUNICACIONES (EUTELSAT)
FGER|FRANCIA/ALEMANIA
FIN|FINLANDIA
FR|FRANCIA
FRIT|FRANCIA/ITALIA
GER|ALEMANIA
GHA|REPÚBLICA DE GHANA
GLOB|?
GREC|GRECIA
GRSA|GRECIA/ARABIA SAUDITA
HUN|HUNGRÍA
IM|ORGANIZACIÓN INTERNACIONAL DE SATÉLITES MÓVILES (INMARSAT)
IND|?
INDO|?
IRAK|IRAK
IRAN|?
IRAQ|IRAK
IRID|?
ISRA|?
ISRO|ORGANIZACIÓN INDIA DE INVESTIGACIÓN ESPACIAL
ISS|ESTACIÓN ESPACIAL INTERNACIONAL
IT|ITALIA
ITSO|ORGANIZACIÓN INTERNACIONAL DE TELECOMUNICACIONES POR SATÉLITE (INTELSAT)
JOR|EL REINO DE HASHEMITE DE JORDANIA
JPN|JAPÓN
KAZ|KAZAJISTÁN
KEN|KENIA
KOR|?
KWT|?
LAOS|?
LKA|REPÚBLICA SOCIALISTA DEMOCRATICA DE SRI LANKA
LTU|LITUANIA
LTV|LETONIA
LUXE|LUXEMBURGO
MA|MARRUECOS
MALA|MALASIA
MCO|MÓNACO
MDA|REPÚBLICA DE MOLDOVA
MMR|REPÚBLICA DE LA UNIÓN DE MYANMAR
MNG|?
MEX|MÉJICO
MUS|?
NATO|ORGANIZACIÓN DEL TRATADO DEL ATLÁNTICO NORTE
NETH|PAÍSES BAJOS
NICO|?
NIG|?
NKOR|REPÚBLICA DEMOCRÁTICA POPULAR DE COREA
NOR|NORUEGA
NPL|REPÚBLICA DEMOCRÁTICA FEDERAL DE NEPAL
NZ|NUEVA ZELANDA
O3B|?
ORB|?
PAKI|PAKISTÁN
PER|PERÚ
PERU|PERÚ
POL|POLONIA
POR|?
PRC|REPÚBLICA POPULAR DE CHINA
PRES|REPÚBLICA POPULAR CHINA/AGENCIA ESPACIAL EUROPEA
PRY|REPUBLICA DE PARAGUAY
QAT|ESTADO DE KATAR
QATR|ESTADO DE KATAR
RASC|?
ROC|TAIWÁN (REPÚBLICA DE CHINA)
ROM|RUMANIA
RP|FILIPINAS (REPÚBLICA DE LAS FILIPINAS)
RWA|REPÚBLICA DE RUANDA
SAFR|SUDÁFRICA
SAUD|ARABIA SAUDITA
SDN|REPUBLICA DE SUDAN
SEAL|?
SES|?
SGJP|SINGAPUR/JAPÓN
SING|SINGAPUR
SK|ESLOVAQUIA
SKOR|REPÚBLICA DE COREA
SPN|ESPAÑA
STCT|SINGAPUR/TAIWÁN
SVN|REPÚBLICA DE ESLOVENIA
SWED|SUECIA
SWTZ|SUIZA
TBD|SER DETERMINADO/DESCONOCIDO
THAI|TAILANDIA
TMMC|TURKMENISTÁN/MÓNACO
TUN|REPÚBLICA DE TÚNEZ
TURK|TURQUÍA
TWN|TAIWÁN
UAE|EMIRATOS ÁRABES UNIDOS
UK|REINO UNIDO
UKR|UCRANIA
URY|?
US|ESTADOS UNIDOS
USBZ|ESTADOS UNIDOS/BRASIL
VAT|ESTADO DE LA CIUDAD DEL VATICANO
VENZ|?
VTNM|?
