AB|ARAB SATELLITE COMMUNICATIONS ORGANIZATION
ABS|ASIA BROADCAST SATELLITE
AGO|REPUBLIC OF ANGOLA
ANG|ANGOLA
AC|ASIA SATELLITE TELECOMMUNICATIONS COMPANY (ASIASAT)
ALG|ALGERIA
ANG|ANGOLA
ARGN|ARGENTINA
ASRA|AUSTRIA
AUS|AUSTRALIA
AZER|AZERBAIJAN
BEL|BELGIUM
BELA|BELARUS
BERM|BERMUDA
BGD|BANGLADESH
BGR|BULGARIA
BHUT|BHUTAN
BOL|BOLIVIA
BUL|BULGARIA
BRAZ|BRAZIL
BT|BHUTAN
CA|CANADA
CHBZ|CHINA/BRAZIL
CHLE|CHILE
CIS|COMMONWEALTH OF INDEPENDENT STATES (FORMER USSR)
COL|COLOMBIA
CRI|COSTA RICA
CZ|CZECHIA
CZCH|CZECH REPUBLIC (FORMER CZECHOSLOVAKIA)
DEN|DENMARK
ECU|ECUADOR
EGYP|EGYPT
ESA|EUROPEAN SPACE AGENCY
ESRO|EUROPEAN SPACE RESEARCH ORGANIZATION
EST|ESTONIA
EUME|EUROPEAN ORGANIZATION FOR THEEXPLOITATION OF METEOROLOGICAL SATELLITES (EUMETSAT)
EUTE|EUROPEAN TELECOMMUNICATIONSSATELLITE ORGANIZATION (EUTELSAT)
FGER|FRANCE/GERMANY
FIN|FINLAND
FR|FRANCE
FRIT|FRANCE/ITALY
GER|GERMANY
GHA|REPUBLIC OF GHANA
GLOB|GLOBALSTAR
GREC|GREECE
GRSA|GREECE/SAUDI ARABIA
HUN|HUNGARY
IM|INTERNATIONAL MOBILE SATELLITE ORGANIZATION (INMARSAT)
IND|INDIA
INDO|INDONESIA
IRAK|IRAQ
IRAN|IRAN
IRAQ|IRAQ
IRID|IRIDIUM
ISRA|ISRAEL
ISRO|INDIAN SPACE RESEARCH ORGANISATION
ISS|INTERNATIONAL SPACE STATION
IT|ITALY
ITSO|INTERNATIONAL TELECOMMUNICATIONSSATELLITE ORGANIZATION (INTELSAT)
JOR|HASHEMITE KINGDOM OF JORDAN
JPN|JAPAN
KAZ|KAZAKHSTAN
KEN|KENYA
KWT|KUWAIT
LAOS|LAOS
LKA|DEMOCRATIC SOCIALIST REPUBLIC OF SRI LANKA
LTU|LITHUANIA
LTV|LATVIA
LUXE|LUXEMBOURG
MA|MOROCCO
MALA|MALAYSIA
MDA|REPUBLIC OF MOLDOVA
MMR|REPUBLIC OF THE UNION OF MYANMAR
MNG|MONGOLIA
MEX|MEXICO
MUS|MAURITIUS
NATO|NORTH ATLANTIC TREATY ORGANIZATION
NETH|NETHERLANDS
NICO|NEW ICO
NIG|NIGERIA
NKOR|DEMOCRATIC PEOPLE'S REPUBLIC OF KOREA
NOR|NORWAY
NPL|FEDERAL DEMOCRATIC REPUBLIC OF NEPAL
NZ|NEW ZEALAND
O3B|O3B NETWORKS
ORB|ORBCOMM
PAKI|PAKISTAN
PER|PERU
PERU|PERU
POL|POLAND
POR|PORTUGAL
PRC|PEOPLE'S REPUBLIC OF CHINA
PRES|PEOPLE'S REPUBLIC OF CHINA/EUROPEAN SPACE AGENCY
PRY|REPUBLIC OF PARAGUAY
QAT|STATE OF QATAR
QATR|STATE OF QATAR
RASC|RASCOMSTAR-QAF
ROC|TAIWAN (REPUBLIC OF CHINA)
ROM|ROMANIA
RP|PHILIPPINES (REPUBLIC OF THE PHILIPPINES)
RWA|REPUBLIC OF RWANDA
SAFR|SOUTH AFRICA
SAUD|SAUDI ARABIA
SDN|REPUBLIC OF SUDAN
SEAL|SEA LAUNCH
SES|SES
SGJP|SINGAPORE/JAPAN
SING|SINGAPORE
SK|SLOVAKIA
SKOR|REPUBLIC OF KOREA
SPN|SPAIN
STCT|SINGAPORE/TAIWAN
SVN|REPUBLIC OF SLOVENIA
SWED|SWEDEN
SWTZ|SWITZERLAND
TBD|TO BE DETERMINED/UNKNOWN
THAI|THAILAND
TMMC|TURKMENISTAN/MONACO
TUN|REPUBLIC OF TUNISIA
TURK|TURKEY
UAE|UNITED ARAB EMIRATES
UK|UNITED KINGDOM
UKR|UKRAINE
URY|URUGUAY
US|UNITED STATES
USBZ|UNITED STATES/BRAZIL
VAT|VATICAN CITY STATE
VENZ|VENEZUELA
VTNM|VIETNAM
